####################
#..................#
#.####.............#
#.#................#
#.#................#
#.#................#
#.#................#
#.#................#
#..................#
####################
