###########################
#............#............#
#.####.#####.#.#####.####.#
#.####.#####.#.#####.####.#
#.........................#
#.####.#.#########.#.####.#
#......#.....#.....#......#
######.#####.#.#####.######
######.#...........#.######
######.#.#### ####.#.######
.........#       #.........
######.#.#########.#.######
######.#...........#.######
######.#.#########.#.######
#............#............#
#.####.#####.#.#####.####.#
#....#.......C.......#....#
####.#.#.#########.#.#.####
#......#.....#.....#......#
#.##########.#.##########.#
#.........................#
###########################


