###########################
#............#............#
#.####.#####.#.#####.####.#
#●#  #.#   #.#.#   #.#  #●#
#.####.#####.#.#####.####.#
#.........................#
#.####.#.#########.#.####.#
#......#.....#.....#......#
######.##### # #####.######
#    #.#           #.#    #
######.# #### #### #.######
1     .  #       #  .     1
######.# ######### #.######
#    #.#           #.#    #
######.# ######### #.######
#............#............#
#.####.#####.#.#####.####.#
#....#.......C.......#....#
####.#.#.#########.#.#.####
#......#.....#.....#......#
#.##########.#.##########.#
#.........................#
###########################


