####################
#C.................#
#.####.............#
#.#................#
#.#................#
#.#................#
#.#................#
#.#................#
#..................#
####################
